C 104,17,17
F 11,227,33
NO ./assets/lavawall1.xpm
SO ./assets/lavawall4.xpm
EA ./assets/lavawall2.xpm
WE ./assets/lavawall3.xpm

1111111111111111111111111

1000000000110000000000001
1011000001110000000000001               
1001000000000000001100001            
1001000000001000000000001            
1001000000000000000000001           
1001000010001000000000001            
10010000000N0000000000001            
1001000110000000000000001           
1001000110000000000000001           
1001000110000000000000001           
1001000110000000000000001                 
1111111111111111111111111