C 104,17,17
F 84,84,84
NO ./assets/png_1.png
SO ./assets/png_2.png
EA ./assets/png_3.png
WE ./assets/png_4.png

111111111111111111111111
100000000000000000000001
110000000000000000000001           11111111111111111
110000000001111110000001           11000000011100001
110000000000000000000001           110000000000N0001
110000000000000000000001           11000000000000001
110000000000000000000001           11111111111111111
110000000000000000000001
110000000000000000000001
110000000000000000000001
110000000000000000000001
110000000000000000000001
110000000000000000000001
110000000000000000000001
110000000000000000000001
110000000000000000000001
110000000000000000000001
110000000000000000000001
110000000000000000000001
110000000000000000000001
110000000000000000000001
110000000000000000000001
100000000000000000000001
100000000000000000000001
111111111111111111111111
111111        1111111111
111111          ...................................