1111111111111111111111111111111111111                       
1000000000110000000000001111111111111                  
1011000001110000000000000000000000011           
1001000000000000000000000000000000011    
1111111110110000011100000000000000011                 
1000000000110000011101110000000000011   
1111011111111101110000000000000000011                 
1111011111111101110101000000000000011        
1100000011010101110000000000000000011                           
1000000000000000000000000000000000011           
1000000000000000000101N00000000000011
1100000111010101111101110000000000011
1111011111101011011110100000000000011
1111111111111111111111111111111111111
