C 104,17,17
F 84,84,84

NO ./assets/png_1.png
SO ./assets/png_2.png
EA ./assets/png_3.png
WE ./assets/png_4.png


1111111111111111111111111111111111111111111111111111111111111111                       
1000000000110000000000001111111111111111111111111111111111111111                  
1010000000000000000000000000000000000000000000000000000000000001           
1010000000000000000000000000000000000000000000000000000000000001           
1010000000000000000000000000000000000000000000000000000000000001           
1010000000000000000000000000000000000000000000000000000000000001           
1010000000000000000000000000000000000000000000000000000000000001           
1010000000000000000000000000000000000000000000000000000000000001           
1010000000000000000000000000000000000000000000000000000000000001           
1010000000000000000000000000000000000000000000000000000000000001           
1010000000000000000000000000000000000000000000000000000000000001           
1010000000000000000000000000000000000000000000000000000000000001           
1010000000000000000000000000000000000000000000000000000000000001           
1010000000000000000000000000000000000000000000000000000000000001           
1010000000000000000000000000000000000000000000000000000000000001           
1010000000000000000000000000000000000000000000000000000000000001           
1010000000000000000000000000000000000000000000000000000000000001           
1010000000000000000000000000000000000000000000000000000000000001           
1010000000000000000000000000000000000000000000000000000000000001           
1010000000000000000000000000000000000000000000000000000000000001           
1010000000000000000000000000000000000000000000000000000000000001           
1010000000000000000000000000000000000000000000000000000000000001
1010000000000000000000000000000000000000000000000000000000000001           
1010000000000000000000000000000000000000000000000000000000000001           
1010000000000000000000000000000000000000000000000000000000000001           
1010000000000000000000000000000000000000000000000000000000000001           
1010000000000000000000000000000000000000000000000000000000000001           
1010000000000000000000000000000000000000000000000000000000000001           
1010000000000000000000000000000000000000000000000000000000000001           
1010000000000000000000000000000000000000000000000000000000000001           
1010000000000000000000000000000000000000000000000000000000000001           
1010000000000000000000000000000000000000000000000000000000000001           
1010000000000000000000000000000000000000000000000000000000000001           
1010000000000000000000000000000000000000000000000000000000000001           
1010000000000000000000000000000000000000000000000000000000000001           
1010000000000000000000000000000000000000000000000000000000000001           
1010000000000000000000000000000000000000000000000000000000000001           
1010000000000000000000000000000000000000000000000000000000000001           
1010000000000000000000000000000000000000000000000000000000000001           
1010000000000000000000000000000000000000000000000000000000000001           
1010000000000000000000000000000000000000000000000000000000000001           
1010000000000000000000000000000000000000000000000000000000000001           
1010000000000000000000000000000000000000000000000000000000000001           
1010000000000000000000000000000000000000000000000000000000000001           
1010000000000000000000000000000000000000000000000000000000000001           
1010000000000000000000000000000000000000000000000000000000000001           
1010000000000000000000000000000000000000000000000000000000000001           
1010000000000000000000000000000000000000000000000000000000000001           
1010000000000000000000000000000000000000000000000000000000000001           
1010000000000000000000000000000000000000000000000000000000000001           
1010000000000000000000000000000000000000000000000000000000000001           
1010000000000000000000000000000000000000000000000000000000000001           
1010000000000000000000000000000000000000000000000000000000000001           
1010000000000000000000000000000000000000000000000000000000000001           
1010000000000000000000000000000000000000000000000000000000000001           
1010000000000000000000000000000000000000000000000000000000000001           
1010000000000000000000000000000000000000000000000000000000000001           
1010000000000000000000000000000000000000000000000000000000000001           
1010000000000000000000000000000000000000000000000000000000000001           
1010000000000000000000000000000000000000000000000000000000000001           
1010000000000000000000000000000000000000000000000000000000000001           
1010000000000000000000000000000000000000000000000000000000000001           
1010000000000000000000000000000000000000000000000000000000000001           
1010000000000000000000000000000000000000000000000000000000000001           
1010000000000000000000000000000000000000000000000000000000000001           
1010000000000000000000000000000000000000000000000000000000000001           
1010000000000000000000000000000000000000000000000000000000000001           
1010000000000000000000000000000000000000000000000000000000000001           
1010000000000000000000000000000000000000000000000000000000000001           
1010000000000000000000000000000000000000000000000000000000000001           
1010000000000000000000000000000000000000000000000000000000000001           
1010000000000000000000000000000000000000000000000000000000000001           
1010000000000000000000000000000000000000000000000000000000000001           
1010000000000000000000000000000000000000000000000000000000000001           
1010000000000000000000000000000000000000000000000000000000000001           
1010000000000000000000000000000000000000000000000000000000000001           
1010000000000000000000000000000000000000000000000000000000000001           
1010000000000000000000000000000000000000000000000000000000000001           
1010000000000000000000000000000000000000000000000000000000000001           
1010000000000000000000000000000000000000000000000000000000000001           
1010000000000000000000000000000000000000000000000000000000000001           
1010000000000000000000000000000000000000000000000000000000000001           
1010000000000000000000000000000000000000000000000000000000000001           
1010000000000000000000000000000000000000000000000000000000000001           
1010000000000000000000000000000000000000000000000000000000000001           
1010000000000000000000000000000000000000000000000000000000000001           
1000000000000000000000000000000000000000000000000000000000000001    
1000000000000000000000000000000000000001000000000000000000000001                 
1000000000000000000000000001100000000001000000000000000000000001   
1000000000000000000000000N00010000000001000000000000000000000001                 
1000000000000000000000000100001000000010100000000000000000000001
1100000000000000000000000010001000000001000000000000000000000001  
1000000000000000000000000001010000000000000000000000000000000011           
1000000000000000000101000000100000000000000000000000000000000011
1100000111010101111101110000000000000000000000000000000000000011
1111011111101011011110100000000000000000000000000000000000000011
1111111111111111111111111111111111111111111111111111111111111111
