

C 0,0,139
F 84,84,84

NO ./assets/png_1.png
SO ./assets/png_2.png
EA ./assets/png_3.png
WE ./assets/png_4.png


1111111111111111111111111111111111111
1000000000110011110000000111111111111                  
1010000000000010010000000000000000001
101000000000001D110000000000000000001     
1010000000000000000000000000000000001            
110000000000000000000S000010001000001
1100000000000000000000000010001000001
1100000000000000000000000010001000001
1100000000000000000000000010001000001
1100000000000000000000000010001000001
1100000000000000000000000010001000001
110001DDDDDDDDDDDDDD11000010001000001
1100000000000000000000000010001000001
1100000000000000000000000010001000001
1100000000000010000000000010001000001
1100000000000100000000000010001000001
1100000000000000000000000010001000001
1100000000011111111110000010001000001
1100000000000000000000000010001000001
1100000000000000000000000010001000001
1100000000000000000000000010001000001
1100000000000000000000000010001000001
1100000000000000000000000010001000001
1100000000111111111100000010001000001
1100000000000000000000000010001000001
1100000000000000000000000010001000001
1100000000000000000000000010001000001
1100000000000000000000000010001000001
1100000000000000000000000010001000001
1100000000000000000000000010001000001
1100000000000000000000000010001000001
1100000000000000000000000010001000001
1100000000000000000000000010001000001
1100000000000000000000000010001000001
1100000000000000000000000010001000001
1100000000000000000000000010001000001
1100000000000000000000000010001000001
1100000000000000000000000010001000001
1100000000000000000000000010001000001
1100000000000000000000000010001000001
1100000000000000000000000010001000001
1100000000000000000000000010001000001
1100000000000000000000000010001000001
1100000000000000000000000010001000001
1100000000000000000000000010001000001
1100000000000000000000000010001000001
1100000000000000000000000010001000001
1100000000000000000000000000001000001
1111111111111111111111111111111111111  
