
C 104,17,17
F 84,84,84

NO ./assets/lavdddddddawall1.xpm
SO ./assets/lavawall4.xpm
EA ./assets/lavawall2.xpm
WE ./assets/lavawall3.xpm

        1111111111111111111111111
        1000000000110000000000001
        1011000001110000000000001
        1001000000000000000000001
111111111011000001110000000000001
111111111100111111111111111111111
111111111111111111111111111111111
100000000011000001110111111111111
11110111111111011100000010001
11110111111111011101010010001
11000000110101011100000010001
10000000000000011000000100001
100000000N0000001101010010001
11000001110101011111011100111
11110111 1110101 101111010001
11111111 1111111 111111111111