1111111111111111111111111111111111111111111111111111111111111111                       
1000000000110000000000001111111111111111111111111111111111111111                  
1010000000000000000000000000000000000000000000000000000000000001           
1000000000000000000000000000000000000000000000000000000000000001    
1000000000000000000000000000000000000001000000000000000000000001                 
1000000000000000000000000001100000000001000000000000000000000001   
1000000000000000000000000010010000000001000000000000000000000001                 
1000000000000000000000000100001000000010100000000000000000000001
1100000000000000000000000010001000000001000000000000000000000001  
1000000000000000000000000001010000000000000000000000000000000011           
1000000000000000000101N00000100000000000000000000000000000000011
1100000111010101111101110000000000000000000000000000000000000011
1111011111101011011110100000000000000000000000000000000000000011
1111111111111111111111111111111111111111111111111111111111111111
