C 104,17,17
F 84,84,84

NO ./assets/png_1.png
SO ./assets/png_2.png
EA ./assets/png_3.png
WE ./assets/png_4.png


1111111111111111111111111111111111111                   
1000000000110011010000001111111111111                  
1010000000000000000000000000000000001
1010000000000000000000000000000000001        
1010000000000000000N00000000000000001              
1100000000000000000000000010001000001
1100000000000000000000000010001000001
1100000000000000000000000010001000001
1100000000000000000000000010001000001
1100000000000000000000000010001000001
1100000000000000000000000010001000001
1100000000000000000000000010001000001
1100000000000000000000000010001000001
1100000000000000000000000010001000001
1100000000000000000000000010001000001
1100000000000000000000000010001000001
1100000000000000000000000010001000001
1100000000000000000000000010001000001
1100000000000000000000000010001000001
1100000000000000000000000010001000001
1100000000000000000000000010001000001
1100000000000000000000000010001000001
1100000000000000000000000010001000001
1100000000000000000000000010001000001
1100000000000000000000000010001000001
1100000000000000000000000010001000001
1100000000000000000000000010001000001
1100000000000000000000000010001000001
1100000000000000000000000010001000001
1100000000000000000000000010001000001
1100000000000000000000000010001000001
1100000000000000000000000010001000001
1100000000000000000000000010001000001
1100000000000000000000000010001000001
1100000000000000000000000010001000001
1100000000000000000000000010001000001
1100000000000000000000000010001000001
1100000000000000000000000010001000001
1100000000000000000000000010001000001
1100000000000000000000000010001000001
1100000000000000000000000010001000001
1100000000000000000000000010001000001
1100000000000000000000000010001000001
1100000000000000000000000010001000001
1100000000000000000000000010001000001
1100000000000000000000000010001000001
1100000000000000000000000010001000001
1100000000000000000000000010001000001
1100000000000000000000000010001000001
1100000000000000000000000010001000001
1100000000000000000000000010001000001
1100000000000000000000000010001000001
1100000000000000000000000010001000001
1100000000000000000000000010001000001
1100000000000000000000000010001000001
1100000000000000000000000010001000001
1100000000000000000000000010001000001
1100000000000000000000000010001000001
1100000000000000000000000010001000001
1100000000000000000000000010001000001
1100000000000000000000000010001000001
1100000000000000000000000010001000001
1100000000000000000000000010001000001
1100000000000000000000000010001000001
1100000000000000000000000000001000001
1100000000000000000000000010001000001
1100000000000000000000000010001000001
1100000000000000000000000010001000001
1100000000000000000000000010001000001
1100000000000000000000000010001000001
1100000000000000000000000010001000001
1100000000000000000000000010001000001
1100000000000000000000000010001000001
1100000000000000000000000010001000001
1100000000000000000000000010001000001
1100000000000000000000000010001000001
1100000000000000000000000010001000001
1100000000000000000000000010001000001
1100000000000000000000000010001000001
1100000000000000000000000010001000001
1100000000000000000000000000001000001
1111111111111111111111111111111111111  
