1111111111111111111111111111111111111                       
1000000000110000000000001111111111111                       
1011000001110000000000001111111111111               
1001000000000000000000001111111111111        
1111111110110000011100000000000011111                     
1000000000110000011101111111111111111       
1111011111111101110000001000111111111                     
1111011111111101110101001000111111111            
1100000011010101110000001000111111111                               
1000000000000000000000001000111111111               
1000000000000000000101N01000111111111
1100000111010101111101111001111111111
1111011111101011011110100011111111111
1111111111111111111111111111111111111