

C 0,0,139
F 84,84,84

NO ./assets/png_1.png
EA ./assets/png_2.png
SO ./assets/png_3.png
WE ./assets/png_4.png


1111111111111111111111111111111111111
1000000000110011110000000111111111111                  
1010000000000010010000000000000000001
1010000000000010110000000000000000001     
1010000000000000000000000000000000001            
1100000000000000000000000010001000001
1100000000000000000000000010001000001
1100000000000000000000000010001000001
11000000000000C0000000000010001000001
11000000000C00N00000000000010001000001
11000000000000C0000000000010001000001
1100010000000000000011000010001000001
1100000000000000000000000010001000001
1100000000000000000000000010001000001
1100000000000010000000000010001000001
1100000000000100000000000010001000001
1100000000000000000000000010001000001
1100000000011111111110000010001000001
1100000000000000000000000010001000001
1100000000000000000000000010001000001
1100000000000000000000000010001000001
1100000000000000000000000010001000001
1100000000000000000000000010001000001
1100000000111111111100000010001000001
1100000000000000000000000010001000001
1100000000000000000000000010001000001
1100000000000000000000000010001000001
1100000000000000000000000010001000001
11000C000000000000000000001C001000001
11111111111111111111111111111111111D1
1                                 1 1
1111111111111111111111111111111111111
1100000000000000000000000010001000001
1100000000000000000000000010001000001
1100000000000000000000000010001000001
1100000000000000000000000010001000001
1100000000000000000000000010001000001
1100000000000000000000000010001000001
1100000000000000000000000010001000001
1100000000000000000000000010001000001
1100000000000000000000000010001000001
1100000000000000000000000010001000001
1100000000000000000000000010001000001
1100000000000000000000000010001000001
1100000000000000000000000010001000001
1100000000000000000000000010001000001
1100000000000000000000000010001000001
1100000000000000000000000010001000001
1100000000000000000000000010001000001
1100000000000000000000000010001000001
1100000000000000000000000000001000001
1111111111111111111111111111111111111