
C 104,17,17
F 84,84,84

NO ./assets/lavdddddddawall1.xpm
SO ./assets/lavawall4.xpm
EA ./assets/lavawall2.xpm
WE ./assets/lavawall3.xpm

111111111111111111111111111111111
100000000011000000000000000000001
101100000111000000000000000000001
100100000000000000000000000000001
111111111011000001110000000000001
111111111100111111111111111111111
111111111111111111111111111111111
100000000011000001110111111111111
111101111111110111000000100000001
111101111111110111010100100000001
110000001101010111000000100000001
100000000000000110000001000000001
100000000N00000011010100100000001
110000011101010111110111001100001
111101111111010111011110100000001
111111111111111111111111111111111