1111111111111111111111111111111111111                   
1000000000110000000000001111111111111                  
1010000000000000000000000000000000001
1010000000000000000000000000000000001         
1010000000000000000000000000000000001              
1010010000000000000000000000000000001     
1010000000000000000000000000000000001         
1010000000000000000000000000000000001         
1000000000000000000000000000000000001    
10000000000000000N0000000000000000001                 
1000000000000000000000000001100000001   
1100000000000000000000000010001000001
1100000000000000000000000010001000001
1100000000000000000000000010001000001
1100000000000000000000000010001000001
1100000000000000000000000010001000001
1100000000000000000000000010001000001
1100000000000000000000000010001000001
1100000000000000000000000010001000001
1100000000000000000000000010001000001
1100000000000000000000000010001000001
1100000000000000000000000010001000001
1100000000000000000000000010001000001
1100000000000000000000000010001000001
1100000000000000000000000010001000001
1100000000000000000000000010001000001
1100000000000000000000000010001000001
1100000000000000000000000010001000001
1100000000000000000000000010001000001
1100000000000000000000000010001000001
1100000000000000000000000010001000001
1100000000000000000000000010001000001
110000                000010001000001
1100000000000000000000000010001000001
1100000000000000000000000010001000001
1100000000000000000000000010001000001
1100000000000000000000000010001000001
1100000000000000000000000010001000001
1100000000000000000000000010001000001
1100000000000000000000000010001000001
1100000000000000000000000010001000001
1100000000000000000000000010001000001
1100000000000000000000000010001000001
1100000000000000000000000000001000001
1111111111111111111111111111111111111                  