NO ./assets/png_1.png
SO ./assets/png_2.png
WE ./assets/png_4.png
EA                ./assets/png_3.png
F 84,84,84
C     104,17,17


111111111111111111111111
100000000000000000000001
110000000000000000000001  11111111111111111
1100000000000000000000011 10000000011100001
11000000000000000000000111 1000000000000001
110000000N0000000000000111 10000000000000001
110000000000000000000001  11111111111111111
110000000000000000000001
110000000000000000000001
110000000000000000000001
110000000000000000000001
110000000000000000000001
110000000000000000000001
110000000000000000000001
110000000000000000000001
110000000000000000000001
110000000000000000000001
110000000000000000000001
110000000000000000000001
110000000000000000000001
110000000000000000000001
110000000000000000000001
100000000000000000000001
100000000000000000000001
111111111111111111111111
