NO ./assets/png_1.png
SO ./assets/png_2.png
WE ./assets/png_4.png
EA ./assets/png_3.png

F  255,45,5
C 135,206,235

11111
11111111
11000001
11000001
11000S01
11111111
11111111