NO ./assets/png_1.png
SO ./assets/png_2.png
WE ./assets/png_4.png
EA ./assets/png_3.png


F 84,84,84
C 104,17,17


1111111111111111111111111
1000000000000000000000001
1000000000000000000000001
1000000000000000000000001
1000000000000000000000001
1000000001D11000000000001
1000000000000000000000001
1000000000000000000000001
1000000000000000000000001
1000000000000000000000001
10000000S0000000000000001
1000000000000000000000001
1000000000000000000000001
10000001D1000000000000001
1000000000000000000000001
1111111111111111111111111

1111111111111111111111111
1111111111111111111111111
