NO ./assets/png_1.png
SO ./assets/png_2.png
WE ./assets/png_4.png
EA ./assets/png_3.png

F 84,84,84
C 104,17,5

1111111111111
11111111111011111
1111111111111111111111111
1000000000000000000000001
1000000000000000000000001   111111111
1000000000000000000000001   100000011
1000000000000000000000001   110000001
1000000000000000000000001   110000001
1000000000000000000000001   110000001
1000000000000000000100001   110000001
1000000000000000000000001   110000001
1000000000000000000000001   110000001
1000000000000000000000001   110000001
1000000000000000000000001   110000001
1000000000000000000000001   110000001
1000000000000000000000001111110S00001
1000000000000000000000000000000000011
10000000000000000000000011111111111111
1000000000000000000000001
1111111111111111111111111





1111111111111111111111111
1000000000000000000000001
1000000001011000000000001
1000000000000000000000001
1000000000000000000000001
1000000000000000000000001
1000000000000000000000001
1000000000000000000000001
1000000000000000000000001
1000000000000000000000001
1000000101000000000000001
1000000000000000000000001
1111111111111111111111111
1111111111111111111111111
