NO ./assets/png_1.png
SO ./assets/png_2.png
WE ./assets/png_4.png
EA ./assets/png_3.png

F 84,84,84
C 104,17,0

1111111111111111111111111
1000000000000000000000001
1000000000000000000000001
1000000000000000000000001
1111111111111111111111111
                      
1111111111111111111111111
1000000000000000000000001
1000000001010000000000001
1000000000000000000000001
1000000000000000000000001
1000000000000000000000001
1000000000000000000000001
10000000S0000000000000001
1000000000000000000000001
1000000000000000000000001
1000000101000000000000001
1000000000000000000000001
1111111111111111111111111
1111111111111111111111111
1111111111111111111111111
