C 104,17,17
F 84,84,84
NO ./assets/png_1.png
SO ./assets/png_2.png
EA ./assets/png_3.png
WE ./assets/png_4.png

1111111111111111111111111             
1000000000110000000000001                          
1011000001110000000000001               
1001000000000000001100001            
100100000S001000000000011         
1001000000000000000000001            
1001000010001000000000001            
1001000000000000000000001            
1001000110000000000000001           
1001000110000000000000001           
1001000110000000000000001           
1001000110000000000000001                 
1111111111111111111111111
