




NO ./assets/card1.png


SO  ./assets/card2.png


WE ./assets/card4.png




EA ./assets/card3.png


F 0,0,0
C 255,0,255



1111111111111111111111111             
1000000000000000000000001                          
1000000000000000000000001
1000000000000000000000001 1111111111111111
100000000000000000000000111111111111111111111111111111111111111111111111111111111111111111111111111111111111111111111111111111111
10000000000000000000000000000000000000000000000000000000000000000000000000000000000000000000000000000000000000000000000000000001
1000000000000000000000001111111111111111111111111111111111111111111111111111111111111111111111111111111111111111111111111111111
1000000000000000000000001
1000000000000000000000001
1000000000000000000001001
100000000000000000000D001
1000000000000000000001001
1000000000000000000000001
1000000000000000000000001
1000000000000000000000001
1000000000000000000000001
1000000000000000000000S001
10000000000000000000000011
1000000000000000000000001                          
1000000000000000000000001                          
1000000001011000000000001                          
1000000000000000000000001                          
1000000000000000000000001                          
1000000000000000000000001                          
1000000000000000000000001                          
1000000000000000000000001                          
1000000000000000000000001                          
1000000000000000000000001                          
1000000101000000000000001                          
1000000000000000000000001                 
1111111111111111111111111
 
1111111111111111111111111
