




NO ./assets/png_1.png


SO  ./assets/png_2.png


WE ./assets/png_3.png




EA ./assets/png_4.png


F 0,0,0
C 255,0,255



1111111111111111111111111             
1000000000001D10000000001                          
1000000000000000000000001
1000000000000000000000001 1111111111111111
10000000000000000000000011111111111111111111111111111111111111111111111111111111111111111111111111111111111111111111111111111111
10000000000000000000000000000000000000000000000000000000000000000000000000000000000000000000000000000000000000000000000000000001
1000000000000000000000001111111111111111111111111111111111111111111111111111111111111111111111111111111111111111111111111111111
1000000000000000000000001
1000000000010000000000001
1000000000010000000001001
1000000001101100000000001
1000000000010000000001001
1000000000010000000000001
1000000000000000000000001
1000000000000000000000001
1000000000000000000000001
10000000000000000000000001
10000000000000000000000011
1000000000000000000000001                          
1000000000000000000000001                          
1000000001011000000000001                          
1000000000000000000000001                          
1000000000000000000000001                          
1000000000000000000000001                          
1000000000000000000000001                          
1000000000000000000000001                          
1000000000000000000000001                          
10000000000000000000000S1                          
1000000101000000000000001                          
1000000000000000000000001                 
1111111111111111111111111
 
1111111111111111111111111
