




NO ./assets/png_1.png








SO               ./assets/png_2.png









WE ./assets/png_4.png
EA ./assets/png_3.png





F 255,84,0




C 104,117,17

1111111111111111111111111             
1000000000000000000000001                          
1000000000000000000000001   111111111
1000000000000000000000001   100000011
1000000000000000000000001   110000001
1000000000000000000000001   110000001
1000000000000000000000001   110000001
1000000000000000000000001   110000001
1000000000000000000000001   110000001
1000000000000000000000001   110000001
1000000000000000000000001   110000001
1000000000000000000000001   110000001
1000000000000000000000001   110000001
1000000000000000000000001111110S00001
100000000000000000000000000000000001
10000000000000000000000011111111111111
1000000000000000000000001                          
1000000000000000000000001                          
1000000001D11000000000001                          
1000000000000000000000001                          
1000000000000000000000001                          
1000000000000000000000001                          
1000000000000000000000001                          
1000000000000000000000001                          
1000000000000000000000001                          
1000000000000000000000001                          
10000001D1000000000000001                          
1000000000000000000000001                         
1111111111111111111111111
