




NO ./assets/card1.png
SO  ./assets/card2.png
WE ./assets/card4.png
EA ./assets/card3.png
F 0,55,0
C 104,117,17










1111111111111
11111111111011111
1111111111111111111111111             
1000000000000000000000001                          
1000000000000000000000001   111111111
1000000000000000000000001   100000011
1000000000000000000000001   110000001
1000000000000000000000001   110000001
1000000000000000000000001   110000001
1000000000000000000000001   110000001
1000000000000000000000001   110000001
1000000000000000000000001   110000001
1000000000000000000000001   110000001
1000000000000000000000001   110000001
1000000000000000000000001   110000001
1000000000000000000000001111110S00001
1000000000000000000000000000000000011
10000000000000000000000011111111111111
1000000000000000000000001                          
1000000000000000000000001                          
1000000001D11000000000001                          
1000000000000000000000001                          
1000000000000000000000001                          
1000000000000000000000001                          
1000000000000000000000001                          
1000000000000000000000001                          
1000000000000000000000001                          
1000000000000000000000001                          
10000001D1000000000000001                          
1000000000000000000000001                         
1111111111111111111111111                          
1111111111111111111111111
