
C 104,17,17

F 84,84,000000000000200


NO ./assets/png_1.png
SO ./assets/png_2.png
EA ./assets/png_3.png
WE ./assets/png_4.png

111111111111111111111111
100000000000000000000001
11000001D100000000000001  11111111111111111
1100000000000000000000011110000000011100001
110000000100100000000000000000000000N000001
1100000000000000000000011110000000000000001
110000000000000000000001  11111111111111111
110000000000000000000001  101
110000000000000000000001  101
110000000000000000000001  101
110000000000000000000001  101
110000000000000000000001  101
110000000000000000000001  101
110000000000000000000001  101
110000000000000000000001  101
110000000000000000000001  101
110000000000000000000001  101
110000000000000000000001  101
110000000000000000000001  101
110000000000000000000001  101
110000000000000000000001  101
110000000000000000000001  101
100000000000000000000001  101
100000000000000000000001  101
111111111111011111111111  101
1111111111110111111111111111111111111111111111111111111111111111111111111111111111111
1111000000000000000000000000000000000000000000000000000000000000000000000000000000001
1111111111111111111111111111111111111111111111111111111111111111111111111111111111111