


NO ./assets/png_1.png





SO ./assets/png_3.png





WE ./assets/png_4.png

EA ./assets/png_2.png
F 84,84,84
C 0,0,139

1111111111111111111111111111111111111
1000000000110011110000000111111111111 111
101000001D100010010000000000000000001
101000001D100010010000000000000000001
101000001D100000000000000000000000001
10100000000000100100000000001010000011
101000000000001001000000000000000001111
10100000000000100100000000000S0000001
1111111111111111111111111111111111111
