

C 0,0,139
F 84,84,84

NO ./assets/png_1.png
EA ./assets/png_2.png
SO ./assets/png_3.png
WE ./assets/png_4.png

1111111111111111111111111111111111111
1000000000110011110000000111111111111
101000001D100010010000000000000000001
1010000000000010010000000000101000001
1010000000000010010000000000000000001
10100000000000100100000000000S0000001
1111111111111111111111111111111111111
