
SO ./assets/png_3.png

EA ./assets/png_2.png
F 0,3,4

NO ./assets/png_1.png
C 0,25,139

WE ./assets/png_4.png

111111111
111000111
100000001
10S000001
100000101
11111111
