
SO ./assets/png_3.png       

EA ./assets/png_2.png   
F 0,0,0

NO ./assets/png_1.png
C 1000,25,139

WE      ./assets/png_4.png

1
    111111
11111111111
10000000001
1000S000001
10000000001
11D10000001
10000000001
10000011111
11111111111
