
SO ./assets/png_3.png       

EA ./assets/png_2.png   
F 0,0,0

NO ./assets/png_1.png
C 0,25,139

WE         ./assets/png_4.png


11111111111
10000000001
100S0000001
10000000001
101D1000001
10000000001
10000011111
11111111111
